*********
*       *
S ****  *
*       G
* * * * *