*********
*       *
*     S G
*       *
*********