*****************************************************************************************************
*             *                       *                   *     *             *         *           *
* ******* *** * ********* ************* ***************** * * * * ********* * * ***** * * ********* *
*   *     * * * *     *   *             *         * *   *   * * * *       * * *     * * *         * *
***** ***** * * * *** * * * ************* ******* * * * ***** * * * ***** * * ***** * * * ********* *
*     *     * * * * * * * * *   *         *   * * * * *   * * * * * *   * * *     * * * * *         *
* ********* * * * * * * *** * * ********* * * * * * * * * * * * *** * *** * ******* * * * * ******* *
* *         * * *   * *     * *           * * * * * * * *   * *     *   * *       * * * * * *     * *
* *** ***** * * ***** ******* ************* * * * * * * ***** ********* * ******* * * * * * * ***** *
*   * *   * * * *     *                     * * * * * *     * *         *       *   * * * * *       *
* * * *** * * * * *** * ********************* * * * * ***** * * *************** ***** * *** * *******
* * *   *   * * * *   * *             *       * * *       * * *               * *     *     *       *
* * * * ***** * * * *** * ************* ******* * ********* * * ************* * * *******************
* * * *       * * *   * *             * *                   * * *       *   * * * *                 *
* * * ********* * ***** ************* * * ***************** * * * ***** * * * * * * *************** *
* * * *   *     * *   *               * *   *     *       * * * * *   * * * * * * * *       *     * *
* * * * * * ***** * * * *************** ***** *** * ******* * * * * * * * * * * * * * ******* *** * *
* * * * * * *     * * * *             *         * *         * * * * * * * * *     * *           * * *
* * * *** * ***** * * * * *********** *********** * ********* * * * *** *** ******* ************* * *
* * *     * *     * * * * *         * *           * *   *   * *   *           *                   * *
* * ******* * ***** * * * ********* * * *********** * * *** * ***************** ******************* *
* * *       *       * * * *         * * *         * * * *   *                     *                 *
* * * *************** * * * ******* * * * ********* * * * ************************* *************** *
* * * *             *   * * *     * * * *           * * *     *                     *               *
* * * ******* ***** * *** * * ***** * * *********** * * ***** * ********************* ***************
* * *       * *     *   * * *       *   *         * * *       * *         *         * *             *
*********** * ***** ***** * ********* *** ******* * * * ******* * ******* * *** *** * * *********** *
*         * *     *       *           *   *     * * * * *       *   *     * * * * * * * *         * *
* ******* * * *** ********* *********** ***** * * * * *** ********* * *** * * * * * * * * *** *** * *
* * *   * * *   *     * *   *     *     *     * * * *   * *         * * * * * * * * * * * * * * * * *
* * * * * * ********* * * *** *** * ***** * *** * * * * * ***** ***** * * * * * * * * * * * * * * * *
* *   *   *         * * * *     * * *     * *   * * * * * *   *   *   *   * * * * * * * *   * *   * *
* ***************** * * * ******* * ******* ***** * *** * * * ***** *** *** * * * * * * ***** ***** *
* *               * * *           *       *       *     * * * *   * *     *   * * * * *       *   G *
* * ************* * * *********** ******* * ************* * * * * * * ******* * * * * ******* * *** *
* *       *     * * *     *     * *     * * *             * * * * * * *       * * * * *     * * * * *
* ******* * *** * * ***** * *** * * *** * * * *** ********* * * * * *** ******* * * * * ***** * * * *
*       * *   * * *       * *   * * * * * * * *   *       * * * * *   * *     * *   * *       * * * *
* ******* * * * * ********* ***** * * * * * * * ***** * * * * * * *** * * ***** * *** * ******* * * *
*         * * * *               * * *   * * * * *   * * * * *   *     *   *     *   * * *     * * * *
* ********* * * *************** * * ***** * * * * * * * * * ************* * ******* * * * * * * * * *
* *         * * *       *       * * *     * * * * * * * * *               * *     * * * * * * * * * *
* * ********* * ***** * * ******* * * ***** * * * * *** * ***************** * ***** * * *** * * * * *
* * *       * *       * *         * * *   * * * * *     *                   *       * *     * * * * *
* * ******* * ********* *********** * * * * * * * *********************************** ******* * * * *
* *         * *       * *           * * * * * * * *                                 *   *   * * * * *
* *********** * ***** * * ********* * * *** * * * * ******************************* *** * *** * * * *
*             *     * * * *       * * *   * * * * *           *                     * * *     * *   *
********************* * * * ******* * * * * * * * *********** * ******************* * * * ***** *****
*                     * * * *       * * * * * * *           * * *                 * * * *     *     *
* ********* ********* * * * * ***** * * * * * * ******* *** * * * ******* ******* * * * *********** *
*         * *       * * * * * *     * * * * * * *     *   * * * * *     * *       * * *             *
*********** * * ***** * * * * * ***** * * * * * * *** *** * * * * *** * * ********* * ************* *
*           * * *     * * * * * *   * * * * * * * * * * * * * * *     * *               *         * *
* ************* * ***** * * * * * * * *** * * * * * * * * * * * *** ********************* ***** *** *
* *     *       * *   * * * * *   * * *   * * * * * * * * *   * * * *                         *     *
* ***** * *** * * * * * * * * ***** * * *** *** * * * * * ***** * * * *******************************
* *     * * * * * * * * * * * *   * * *         * * * * * *   * * * * *     *   *   * *             *
* * *** * * * * * * * * * * * * * * * *********** * * * * * * * * * * * *** * * * * * * *********** *
* * *   * * * * * * * * * * * * * * *               * * * * * * * * * *   * * *   *   *   *       * *
* * ***** * * * * * * * * * * * * * ***************** * * * * * * * * * * * * *********** ******* * *
* *         * * * * * * *   * * * * *       *         * * * * * * * * * * * *           * *       * *
* ******* *** * * *** * ***** * * * * ***** * ********* * * * * * * * * * * * ********* * * ***** * *
* *     * *   * *     *       * * * *     * * *         * * * * *   * * * * *         * * * *   * * *
* * *** * * *** ***** ********* * * * *** * * * ********* * * * ***** *** * *********** * * * * * ***
* *   * * * *   *   * *     *   * * *   * * * *             * *           *             * * * * * * *
* *** * * * ***** * * * * * * ***** ***** * * ******************************************* * * * * * *
* *   * * *     * * * * * * *     * *     * *           *                                 * * * * * *
* * *** * ***** * * * * * * * *** * * ***** *********** * ********************************* * * * * *
* *   * *     * * * * * * * *   * * * *     *           * *         *             *         * * * * *
* * * * ******* * * * * * * ***** * * * ***** *********** * ***** * * *** ******* * ******* * * * * *
* * * * *       * * * * * *       * * *     *           * * *   * * * * * *       * *     * * * * * *
* * * * * ******* * * * * * ******* * ***************** * * * * * * * * * * ******* * ***** * * * * *
* * * * *         * * * * * *       *                 * * * * * * * *   * *     * * *     * * * *   *
* * * * *********** * * * * * ************* * ********* * * * * * * ***** ***** * * * *** * * ***** *
* * * *             * * * * * *             * *         * * * * * * *     *   * *   * * * * *       *
* * * *************** * * * * * ************* * ******* * * * * * * * ******* * *** * * * * *********
* * * *               * * * * * *           * * * *     * * * * * * *   *     *   * *   * * *       *
* *** * ***************** * * * * *********** * * * ***** * * *** * * * * ******* * ***** * * ***** *
* *   * *           *     * * * *           * * *       * * *   * * * * *       * *       * * *   * *
* * * * ***** ***** * ***** * * * ********* * * ********* * * * * * * * * ***** * ********* * * *** *
* * * *       *   * * *     * * * * *     * * *           * * * * * * * * *   * * *         * *   * *
* * *********** *** * ******* * * * * * * * * ************* * * * * * * * * * * * * ********* *** * *
* *       *         *       * * * * * * * * * *           * * * * * * * * * * * * *               * *
* ******* * *************** * * * * * * * * * * ********* * *** * * *** * * * * * * *************** *
* *       * *               * * * * * * * * * * *   *     *     * *     * * * * * *       *     *   *
* * ******* *** ************* * * * * * * * * * *** * *** * ***** ******* *** * * * ******* *** * * *
* *             *           * * * * * * * *   *     * * * * *     *           * * * *       *   * * *
* *************** ********* * * * * * * ************* * * * * ***************** * * * ******* *** * *
* *               *   *   * * * * * * *             * * * * * *                 * * * *   * * *   * *
* * *************** *** * * * * * * * ******* ***** * * * * * ***** *********** * * * * * * * * * * *
* * *     *       *     * * * * * *   *     * *   * * *   * * *     *         * * * * * *   * * * * *
* * * ***** * *** ******* * * * * * ******* * * *** * * *** * * ***** *** *** * * * * * ***** * * * *
* * *       * *           * * * * * *       * *   * * *S  * * * *   *   * * * * * * * *     * * * * *
* * ********* *********** * * * * * * ******* * * * * ***** * * * * ***** * * * * *** * *** * * * * *
* * *         *       *   * * * * * *       * * * * *       * * * *       *   * *     * *   * * * * *
* * * ******* * ***** ***** * * * * ******* * *** * * ******* * * ************* ******* * * * * * * *
* * * *       * *           * * * *         * *   * *       * * *                     * * * * * * * *
* * * * ******* ************* * * *********** * *** ********* * *********************** * *** *** * *
*     *       *                 *             *               *                         *         * *
*****************************************************************************************************